5 5 0 0 0 0 0 0 
0 0 0 4 3 1 3 0  
0 3 3 2 3 3 3 0  
0 3 43 3 3 3 3 0 
0 3 3 1 3 4 3 0  
0 3 3 3 3 0 0 0  
0 0 0 0 0 0 5 5 