0 0 0 0 0 0 0
0 3 3 1 3 4 0
0 2 3 0 0 0 0
0 3 3 0 5 5 5
0 0 0 0 5 5 5